3,6,2,7,7,3,6,6,8,6
4,8,2,8,4,8,3,8,4,4
1,2,4,0,7,8,8,2,5,7
7,8,5,0,9,5,8,3,4,1
1,0,8,7,0,0,6,4,1,1
8,6,7,1,2,7,2,2,2,4
8,0,7,6,9,4,4,0,6,7
7,8,9,0,0,4,2,0,0,2
0,3,7,3,8,7,1,9,0,7
8,7,7,7,5,2,0,5,9,0
